111111111
10C000001
1000P0001
10C001001
100000E01
111111111