11111111111111111111111111
10C00000111111111111111111
1000P000111111111111111111
10C00100111111111111111111
100000E0111111111111111111
11111111111111111111111111
11111111111111111111111111
11111111111111111111111111
11111111111111111111111111
11111111111111111111111111
11111111111111111111111111
11111111111111111111111111
11111111111111111111111111