1111111111111111111111111
100000P000000000C00000001
111111111C000000000000001
1E00000000000000000000001
1000000000000000C11111111
1111111111111111111111111