1111111111111111111111111
1C000000000C000C000000001
100000000P000000000000C01
1C00000000000000000000001
111000011111100000C000001
1C00001000001000000000001
100000100C00010000C000C01
1000001000000111110000001
100C000000C00000000100001
1E00000000000000000100C01
1111111111111111111111111