1111111111
1PCCCCCCE1
1CCCCCCCC1
1111111111